10 10
S . . . . . . . . .
. . . . . . . . . .
. . . . . . . . . .
. . . . . . . . . .
. . . . . . . . . .
# # # # # # . . . .
. . . . . # . . . .
. . . . . # . . . .
. . . . . # . . . .
. . . . . # . . . E